Fecha,Oficina,Descripción,Referencia,Secuencial,Cheque Propio / Local / Efectivo,Débito (-),Crédito (+),Saldo Contable,Saldo Disponible
28/02/2025,992,N/DEBITO TRANSFERENCIA ACH,76660693,76660693,,2300.0,0,176201.68,176201.68
28/02/2025,9136,primera cuota,77497515,77497498,EFECTIVO,0,475.0,176676.68,176676.68
28/02/2025,9136,Pago de prstmo,82827315,82827292,EFECTIVO,0,800.0,177476.68,177476.68
28/02/2025,996,N/CREDITO DEPOSITO COMPLETO CAJA RURAL,83727740,83727740,EFECTIVO,0,600.0,178076.68,178076.68
28/02/2025,996,N/CREDITO DEPOSITO COMPLETO CAJA RURAL,83751446,83751446,EFECTIVO,0,400.0,178476.68,178476.68
28/02/2025,9136,cuota febrero Gaby Guay,86370983,86370946,EFECTIVO,0,1217.0,179693.68,179693.68
28/02/2025,996,N/CREDITO DEPOSITO COMPLETO CAJA RURAL,89294145,89294145,EFECTIVO,0,1084.0,180777.68,180777.68
28/02/2025,996,N/CREDITO DEPOSITO COMPLETO CAJA RURAL,97161582,97161582,EFECTIVO,0,608.0,181385.68,181385.68
28/02/2025,948,PAGO DE ALQUILER,107308265,107308248,,1500.0,0,179885.68,179885.68
28/02/2025,948,PAGO DE INTERNET,107398983,107398979,,200.0,0,179685.68,179685.68
28/02/2025,948,PAGO DE PLANILLA,107469983,107469979,,1318.63,0,178367.05,178367.05
28/02/2025,948,PAGO DE PLANILLA,107652823,107652813,,904.15,0,177462.90,177462.90
28/02/2025,948,PAGO DE SERIVICIOS CONTABLES,107717865,107717856,,1475.0,0,175987.90,175987.90
28/02/2025,948,PAGO AC-002-2025,107801821,107801815,,164.0,0,175823.90,175823.90
28/02/2025,948,PAGO AC-003-2025,107867139,107867129,,160.0,0,175663.90,175663.90
28/02/2025,948,PAGO AC-020-2024,107921031,107921022,,1775.0,0,173888.90,173888.90
28/02/2025,948,PAGO AC-026-2024,107980899,107980887,,116.0,0,173772.90,173772.90
28/02/2025,948,PAGO DE AC-007-2024,108062317,108062313,,4584.0,0,169188.90,169188.90
28/02/2025,948,PAGO AC-006-2024,108116834,108116818,,4584.0,0,164604.90,164604.90
28/02/2025,948,PAGO AC-004-2024,108171781,108171769,,13000.0,0,151604.90,151604.90
28/02/2025,948,PAGO AC-003-2024,108223313,108223300,,1650.0,0,149954.90,149954.90
28/02/2025,948,PAGO AC-002-2024,108282606,108282598,,917.0,0,149037.90,149037.90
28/02/2025,948,PAGO AC-015-2023,108342496,108342488,,4313.0,0,144724.90,144724.90
28/02/2025,996,N/CREDITO DEPOSITO COMPLETO CAJA RURAL,114203604,114203604,EFECTIVO,0,119.0,144843.90,144843.90
28/02/2025,996,N/CREDITO DEPOSITO COMPLETO CAJA RURAL,114235036,114235036,EFECTIVO,0,800.0,145643.90,145643.90
28/02/2025,9755,N/CREDITO TRANSFERENCIA ELECTRONICA TIF,114820845,114820845,EFECTIVO,0,1500.0,147143.90,147143.90
28/02/2025,133,DEPOSITO COMPLETO,55585805,117126084,EFECTIVO,0,1300.0,148443.90,148443.90
28/02/2025,948,REINTEGRO DE COMPRAS Y SERVICI,117174470,117174466,,18000.0,0,130443.90,130443.90
28/02/2025,996,N/CREDITO DEPOSITO COMPLETO CAJA RURAL,117275322,117275322,EFECTIVO,0,1300.0,131743.90,131743.90
28/02/2025,9755,N/CREDITO TRANSFERENCIA ELECTRONICA TIF,117365078,117365078,EFECTIVO,0,575.0,132318.90,132318.90
28/02/2025,9755,N/CREDITO TRANSFERENCIA ELECTRONICA TIF,118136179,118136179,EFECTIVO,0,4285.0,136603.90,136603.90
28/02/2025,996,N/CREDITO DEPOSITO COMPLETO CAJA RURAL,118738418,118738418,EFECTIVO,0,1262.0,137865.90,137865.90
28/02/2025,9136,Cuota de crédito 2/3,119334030,119334013,EFECTIVO,0,1408.0,139273.90,139273.90
01/03/2025,996,N/CREDITO DEPOSITO COMPLETO CAJA RURAL,129308956,129308956,EFECTIVO,0,1149.0,140422.90,140422.90
01/03/2025,9755,N/CREDITO TRANSFERENCIA ELECTRONICA TIF,129897865,129897865,EFECTIVO,0,2000.0,142422.90,142422.90
01/03/2025,996,N/CREDITO DEPOSITO COMPLETO CAJA RURAL,130357006,130357006,EFECTIVO,0,867.0,143289.90,143289.90
01/03/2025,9136,ab,131344558,131344528,EFECTIVO,0,200.0,143489.90,143489.90
01/03/2025,9136,5o pago,143895210,143895147,EFECTIVO,0,689.0,144178.90,144178.90
01/03/2025,948,SERVICIOS FINANCIEROS,151444976,151444975,,10000.0,0,134178.90,134178.90
01/03/2025,9136,pago de Elvis,151841083,151841079,EFECTIVO,0,200.0,134378.90,134378.90
01/03/2025,9755,N/CREDITO TRANSFERENCIA ELECTRONICA TIF,152004808,152004808,EFECTIVO,0,100.0,134478.90,134478.90
01/03/2025,711,DEPOSITO COMPLETO,65815006,152023199,EFECTIVO,0,2277.0,136755.90,136755.90
01/03/2025,996,N/CREDITO DEPOSITO COMPLETO CAJA RURAL,152326838,152326838,EFECTIVO,0,411.0,137166.90,137166.90
03/03/2025,9755,N/CREDITO TRANSFERENCIA ELECTRONICA TIF,169165603,169165603,EFECTIVO,0,1262.0,138428.90,138428.90
03/03/2025,9136,a,174045964,174045927,EFECTIVO,0,2103.0,140531.90,140531.90
03/03/2025,992,N/CREDITO TRANSFERENCIA ACH,184547491,184547491,EFECTIVO,0,1000.0,141531.90,141531.90
03/03/2025,992,N/CREDITO TRANSFERENCIA ACH,184547559,184547559,EFECTIVO,0,879.0,142410.90,142410.90
03/03/2025,992,N/CREDITO TRANSFERENCIA ACH,184547635,184547635,EFECTIVO,0,405.0,142815.90,142815.90
03/03/2025,948,SERVICIOS FINANCIEROS,187464788,187464783,,3000.0,0,139815.90,139815.90
03/03/2025,996,N/CREDITO DEPOSITO COMPLETO CAJA RURAL,204029909,204029909,EFECTIVO,0,200.0,140015.90,140015.90
03/03/2025,711,DEPOSITO COMPLETO,65824589,208044819,EFECTIVO,0,2182.0,142197.90,142197.90
04/03/2025,9755,N/CREDITO TRANSFERENCIA ELECTRONICA TIF,215119575,215119575,EFECTIVO,0,2561.0,144758.90,144758.90
04/03/2025,9136,credito,220859354,220859290,EFECTIVO,0,4593.0,149351.90,149351.90
04/03/2025,133,DEPOSITO COMPLETO,55593166,228916701,EFECTIVO,0,600.0,149951.90,149951.90
04/03/2025,694,DEPOSITO COMPLETO,64374694,237450069,EFECTIVO,0,2352.0,152303.90,152303.90
04/03/2025,996,N/CREDITO DEPOSITO COMPLETO CAJA RURAL,240155312,240155312,EFECTIVO,0,630.0,152933.90,152933.90
04/03/2025,9755,N/DEBITO TRANSFERENCIA ELECTRONICA TIF,243830775,243830775,,4000.0,0,148933.90,148933.90
04/03/2025,9136,.,244146909,244146875,EFECTIVO,0,1875.0,150808.90,150808.90
04/03/2025,996,N/CREDITO DEPOSITO COMPLETO CAJA RURAL,244766752,244766752,EFECTIVO,0,1000.0,151808.90,151808.90
04/03/2025,9136,pago,245629414,245629400,EFECTIVO,0,1149.0,152957.90,152957.90
05/03/2025,9755,N/DEBITO TRANSFERENCIA ELECTRONICA TIF,260220501,260220501,,4000.0,0,148957.90,148957.90
05/03/2025,9755,N/DEBITO TRANSFERENCIA ELECTRONICA TIF,260283561,260283561,,4853.0,0,144104.90,144104.90
