Fecha,Oficina,Descripción,Referencia,Secuencial,Cheque Propio / Local / Efectivo,Débito (-),Crédito (+),Saldo Contable,Saldo Disponible
12/02/2025,948,PAGO AC-005-2024,1734056396,1734056394,,550.0,0,168656.46,168656.46
12/02/2025,948,PAGO AC-012-2024,1734063844,1734063843,,2875.0,0,165781.46,165781.46
12/02/2025,948,PAGO AC-013-2024,1734071166,1734071162,,3834.0,0,161947.46,161947.46
12/02/2025,948,PAGO AC-024-2024,1734080948,1734080947,,203.0,0,161744.46,161744.46
12/02/2025,948,PAGO AC-022-2024,1734088353,1734088352,,6400.0,0,155344.46,155344.46
12/02/2025,948,PAGO DE COMISIONES,1735663959,1735663953,,9381.0,0,145963.46,145963.46
12/02/2025,9755,N/CREDITO TRANSFERENCIA ELECTRONICA TIF,1758736990,1758736990,EFECTIVO,0,3021.0,148984.46,148984.46
12/02/2025,996,N/CREDITO DEPOSITO COMPLETO CAJA RURAL,1762677454,1762677454,EFECTIVO,0,792.0,149776.46,149776.46
12/02/2025,996,N/CREDITO DEPOSITO COMPLETO CAJA RURAL,1763286229,1763286229,EFECTIVO,0,1000.0,150776.46,150776.46
13/02/2025,483,DEPOSITO COMPLETO,28867999,1773149656,EFECTIVO,0,1000.0,151776.46,151776.46
13/02/2025,696,DEPOSITO COMPLETO,59742597,1783311210,EFECTIVO,0,500.0,152276.46,152276.46
14/02/2025,9136,pago de credito francisco orel,1806672012,1806671988,EFECTIVO,0,2300.0,154576.46,154576.46
14/02/2025,536,DEPOSITO COMPLETO,61855216,1809922671,EFECTIVO,0,4403.0,158979.46,158979.46
14/02/2025,9136,Pago de prestamo,1810911031,1810911009,EFECTIVO,0,1837.0,160816.46,160816.46
14/02/2025,9755,N/CREDITO TRANSFERENCIA ELECTRONICA TIF,1818371420,1818371420,EFECTIVO,0,400.0,161216.46,161216.46
14/02/2025,996,N/CREDITO DEPOSITO COMPLETO CAJA RURAL,1821891944,1821891944,EFECTIVO,0,1000.0,162216.46,162216.46
14/02/2025,9755,N/CREDITO TRANSFERENCIA ELECTRONICA TIF,1830219725,1830219725,EFECTIVO,0,3749.0,165965.46,165965.46
14/02/2025,9755,N/CREDITO TRANSFERENCIA ELECTRONICA TIF,1830357477,1830357477,EFECTIVO,0,162.0,166127.46,166127.46
14/02/2025,948,PAGO DE PLANILLA,1831929830,1831929829,,1268.63,0,164858.83,164858.83
14/02/2025,948,PAGO DE PLANILLA,1831936813,1831936812,,779.15,0,164079.68,164079.68
14/02/2025,9136,Interes Nelson Sierra,1832433405,1832433404,EFECTIVO,0,375.0,164454.68,164454.68
15/02/2025,996,N/CREDITO DEPOSITO COMPLETO CAJA RURAL,1844510797,1844510797,EFECTIVO,0,723.0,165177.68,165177.68
15/02/2025,996,N/CREDITO DEPOSITO COMPLETO CAJA RURAL,1850775393,1850775393,EFECTIVO,0,2000.0,167177.68,167177.68
15/02/2025,996,N/CREDITO DEPOSITO COMPLETO CAJA RURAL,1850787593,1850787593,EFECTIVO,0,500.0,167677.68,167677.68
15/02/2025,133,DEPOSITO COMPLETO,55594071,1854328519,EFECTIVO,0,6032.0,173709.68,173709.68
16/02/2025,948,SERVICIOS FINANCIEROS,1862616398,1862616396,,2000.0,0,171709.68,171709.68
16/02/2025,9136,ABONO PRESTAMO,1863513798,1863513796,EFECTIVO,0,6000.0,177709.68,177709.68
16/02/2025,9136,cuota de crédito,1863722343,1863722342,EFECTIVO,0,865.0,178574.68,178574.68
17/02/2025,536,DEPOSITO COMPLETO,61859063,1884546604,EFECTIVO,0,8000.0,186574.68,186574.68
17/02/2025,992,N/CREDITO TRANSFERENCIA ACH,1890574414,1890574414,EFECTIVO,0,500.0,187074.68,187074.68
17/02/2025,996,N/CREDITO DEPOSITO COMPLETO CAJA RURAL,1892724429,1892724429,EFECTIVO,0,1000.0,188074.68,188074.68
17/02/2025,996,N/CREDITO DEPOSITO COMPLETO CAJA RURAL,1892777482,1892777482,EFECTIVO,0,893.0,188967.68,188967.68
17/02/2025,948,Servicios financieros,1894559501,1894559496,,15000.0,0,173967.68,173967.68
17/02/2025,9755,N/DEBITO TRANSFERENCIA ELECTRONICA TIF,1894768018,1894768018,,5000.0,0,168967.68,168967.68
17/02/2025,948,SERVICIOS FINANCIEROS,1896397174,1896397173,,7501.0,0,161466.68,161466.68
17/02/2025,9755,N/DEBITO TRANSFERENCIA ELECTRONICA TIF,1896428152,1896428152,,5000.0,0,156466.68,156466.68
18/02/2025,9136,Pago crédito gracias,1898987590,1898987575,EFECTIVO,0,4050.0,160516.68,160516.68
18/02/2025,9755,N/CREDITO TRANSFERENCIA ELECTRONICA TIF,1904375432,1904375432,EFECTIVO,0,3300.0,163816.68,163816.68
18/02/2025,948,REINTEGRO EVELY CAJBON,1909271599,1909271593,,2000.0,0,161816.68,161816.68
18/02/2025,9755,N/CREDITO TRANSFERENCIA ELECTRONICA TIF,1910202279,1910202279,EFECTIVO,0,453.0,162269.68,162269.68
18/02/2025,996,N/CREDITO DEPOSITO COMPLETO CAJA RURAL,1910696005,1910696005,EFECTIVO,0,2297.0,164566.68,164566.68
18/02/2025,9136,Pago rolando,1914024782,1914024759,EFECTIVO,0,500.0,165066.68,165066.68
18/02/2025,996,N/CREDITO DEPOSITO COMPLETO CAJA RURAL,1918516940,1918516940,EFECTIVO,0,1149.0,166215.68,166215.68
18/02/2025,9755,N/DEBITO TRANSFERENCIA ELECTRONICA TIF,1922145504,1922145504,,5000.0,0,161215.68,161215.68
18/02/2025,996,N/CREDITO DEPOSITO COMPLETO CAJA RURAL,1926121951,1926121951,EFECTIVO,0,3838.0,165053.68,165053.68
18/02/2025,996,N/CREDITO DEPOSITO COMPLETO CAJA RURAL,1932148517,1932148517,EFECTIVO,0,1000.0,166053.68,166053.68
18/02/2025,9136,Pagos,1933774450,1933774447,EFECTIVO,0,2368.0,168421.68,168421.68
19/02/2025,9136,pago,1943769250,1943769207,EFECTIVO,0,1378.0,169799.68,169799.68
19/02/2025,996,N/CREDITO DEPOSITO COMPLETO CAJA RURAL,1952954029,1952954029,EFECTIVO,0,1400.0,171199.68,171199.68
19/02/2025,9755,N/DEBITO TRANSFERENCIA ELECTRONICA TIF,1955609568,1955609568,,6000.0,0,165199.68,165199.68
19/02/2025,9136,Matilde Prado,1960262231,1960262202,EFECTIVO,0,5780.0,170979.68,170979.68
19/02/2025,253,DEPOSITO COMPLETO,63913115,1961293660,EFECTIVO,0,4593.0,175572.68,175572.68
20/02/2025,9136,2da cuota/3,1969403684,1969403674,EFECTIVO,0,4022.0,179594.68,179594.68
20/02/2025,996,N/CREDITO DEPOSITO COMPLETO CAJA RURAL,1974884358,1974884358,EFECTIVO,0,2442.0,182036.68,182036.68
20/02/2025,996,N/CREDITO DEPOSITO COMPLETO CAJA RURAL,1979091849,1979091849,EFECTIVO,0,3300.0,185336.68,185336.68
20/02/2025,948,SERVICIOS FINANCIEROS,1984828644,1984828641,,1000.0,0,184336.68,184336.68
20/02/2025,996,N/CREDITO DEPOSITO COMPLETO CAJA RURAL,1992295949,1992295949,EFECTIVO,0,1200.0,185536.68,185536.68
20/02/2025,9755,N/DEBITO TRANSFERENCIA ELECTRONICA TIF,1998583966,1998583966,,17000.0,0,168536.68,168536.68
20/02/2025,996,N/CREDITO DEPOSITO COMPLETO CAJA RURAL,1998837247,1998837247,EFECTIVO,0,1500.0,170036.68,170036.68
20/02/2025,996,N/CREDITO DEPOSITO COMPLETO CAJA RURAL,1999076710,1999076710,EFECTIVO,0,1905.0,171941.68,171941.68
20/02/2025,9136,ab,1999305912,1999305911,EFECTIVO,0,200.0,172141.68,172141.68
21/02/2025,789,OPERACION CHEQUE PROPIO,205,2007509597,,4000.0,0,168141.68,168141.68
21/02/2025,133,DEPOSITO COMPLETO,5578565,2014058442,EFECTIVO,0,209.0,168350.68,168350.68
21/02/2025,9755,N/DEBITO TRANSFERENCIA ELECTRONICA TIF,2021657457,2021657457,,2538.0,0,165812.68,165812.68
22/02/2025,948,REINTEGOR DE COMPRAS VARIAS,2038529932,2038529927,,2652.0,0,163160.68,163160.68
22/02/2025,948,PAGO AC-021-2024,2038662526,2038662522,,2934.0,0,160226.68,160226.68
22/02/2025,948,PAGO AC-023-2024,2038695581,2038695576,,800.0,0,159426.68,159426.68
22/02/2025,948,PAGO AC-025-2024,2038723802,2038723800,,2688.0,0,156738.68,156738.68
22/02/2025,948,PAGO AC-027-2024,2038755575,2038755572,,166.0,0,156572.68,156572.68
22/02/2025,948,PAGO AC-001-2025,2038788368,2038788356,,2888.0,0,153684.68,153684.68
22/02/2025,948,PAGO AC-001-2024,2038821597,2038821592,,318.0,0,153366.68,153366.68
22/02/2025,948,PAGO AC-003-2024,2038858487,2038858477,,253.0,0,153113.68,153113.68
22/02/2025,9755,N/DEBITO TRANSFERENCIA ELECTRONICA TIF,2053961414,2053961414,,2000.0,0,151113.68,151113.68
22/02/2025,133,DEPOSITO COMPLETO,60266088,2054827983,EFECTIVO,0,13830.0,164943.68,164943.68
24/02/2025,968,N/DEBITO PAGO BANCA SAT - BANCA VIRTUAL,2099425068,2099425068,,1800.0,0,163143.68,163143.68
24/02/2025,9136,Pago Febrero,2099500371,2099500350,EFECTIVO,0,1149.0,164292.68,164292.68
24/02/2025,9136,Prestamo,2101065069,2101065063,EFECTIVO,0,805.0,165097.68,165097.68
24/02/2025,9136,Letra enero Berny Colman,2102345587,2102345586,EFECTIVO,0,10306.0,175403.68,175403.68
25/02/2025,127,DEPOSITO COMPLETO,22706398,2136135049,EFECTIVO,0,1000.0,176403.68,176403.68
25/02/2025,996,N/CREDITO DEPOSITO COMPLETO CAJA RURAL,2139972460,2139972460,EFECTIVO,0,2000.0,178403.68,178403.68
25/02/2025,996,N/CREDITO DEPOSITO COMPLETO CAJA RURAL,2139986373,2139986373,EFECTIVO,0,1445.0,179848.68,179848.68
26/02/2025,948,SERVICIOS FINANCIEROS,5325427,5325414,,35971.0,0,143877.68,143877.68
26/02/2025,948,PAGO DE HONORARIOS,5394749,5394741,,375.0,0,143502.68,143502.68
26/02/2025,948,PAGO DE HONORARIOS,5459400,5459393,,1609.0,0,141893.68,141893.68
